12.ox
.o...o......
..o...oo....
............
......oo....
............
.......o....
............
............
............
............
......o.....
............
